|--------------------|
|....................|
|...W............W...|
|.-----........-----.|
|....................|
|......--------......|
|....................|
|...---........---...|
|.F....W..---...B....|
|..............----..|
|....B...............|
|....-------.........|
|..............H.....|
|............-----...|
|....................|
|.......------.......|
|.....BBB............|
|....-----...........|
|.................B..|
|--------------------|