|--------------------|
|.B.B.B........B.B.B.|
|...W............W...|
|.-----........-----.|
|..........H.........|
|......--------......|
|....................|
|...---........---...|
|.......F.---...B....|
|..............----..|
|....................|
|....-------.........|
|....................|
|............-----...|
|....................|
|.......------.......|
|......B.............|
|....-----...........|
|....................|
|--------------------|