|--------------------|
|....................|
|.....B..............|
|....----....-----...|
|....................|
|....................|
|.......W.....B......|
|...-------------....|
|....................|
|....................|
|...P..............W.|
|---------BBB--------|
|....................|
|....................|
|....................|
|....................|
|.......H.....B......|
|.....-----------....|
|F.........W.........|
|--------------------|