|--------------------|
|...H............B...|
|..------......A.....|
|.............----...|
|.B.---..............|
|.--.................|
|......A............B|
|.....---------......|
|....................|
|--------------------|