|--------------------|
|....B...............|
|..------......W.....|
|.............----...|
|....................|
|....................|
|........B...........|
|.....---------......|
|.W.........-H--.....|
|------.....---......|
|....................|
|......B.............|
|.....--.............|
|..............----..|
|..W.................|
|..--.........B......|
|......--------......|
|....................|
|....................|
|--------------------|