|--------------------|
|................P...|
|..------............|
|.............----...|
|....B.H.............|
|.........W..........|
|....................|
|.....---------......|
|....................|
|------.....---......|
|....................|
|....................|
|....................|
|....................|
|....................|
|.....---...---......|
|.........W..........|
|.....---------......|
|....................|
|--------------------|