|--------------------|
|....H...............|
|..------.......P....|
|.............----...|
|....................|
|....................|
|.........W..........|
|...-------------....|
|....................|
|------.....---......|
|....................|
|....................|
|....................|
|....................|
|......B.....B.......|
|.....---...---......|
|.........W..........|
|.....---------......|
|....................|
|--------------------|