|--------------------|
|...W..........BB....|
|..------............|
|.............----...|
|....B.............F.|
|.............W......|
|....................|
|.....---------...F..|
|.W..................|
|------.....---......|
|....................|
|....................|
|.....--.....----....|
|....................|
|..F.................|
|.....---...---......|
|.........W..........|
|.....---------......|
|................B...|
|--------------------|