|--------------------|
|..B.............B...|
|..------............|
|.............----...|
|......H.............|
|....................|
|.............W......|
|.....---------......|
|....................|
|------.....---......|
|....................|
|....................|
|....................|
|....................|
|....................|
|.....---...---......|
|.......B.W.B........|
|.....---------......|
|....................|
|--------------------|